111111111111111111111111111111111111111111
111110000000000000000000000000000000000001
111000000000000000000000000000000000001111
111000000000000000000000000000000000001111
111000000000000000000000000000000000001111
111000000000000000000000000000000000001111
111000000000000000000000000000000000001111
111000000000000000000000000000000000001111
111000000000000000000000000000000000001111
111000000000000000000000000000000000001111
111000000000000000000000000000000000001111
111000000000000000000000000000000000001111
111000000000000000000000000000000000001111
111000000000000000000000000000000000001111
111000000000000000000000000000000000001111
111111111111111111111111111111111111111111
